^@	NULL (NUL)
^A	START OF HEADING (SOH)
^B	START OF TEXT (STX)
^C	END OF TEXT (ETX)
^D	END OF TRANSMISSION (EOT)
^E	ENQUIRY (ENQ)
^F	ACKNOWLEDGE (ACK)
^G	BELL (BEL)
^H	BACKSPACE (BS)
^I	CHARACTER TABULATION (HT)
^@	LINE FEED (LF)
^K	LINE TABULATION (VT)
^L	FORM FEED (FF)
^M	CARRIAGE RETURN (CR)
^N	SHIFT OUT (SO)
^O	SHIFT IN (SI)
^P	DATALINK ESCAPE (DLE)
^Q	DEVICE CONTROL ONE (DC1)
^R	DEVICE CONTROL TWO (DC2)
^S	DEVICE CONTROL THREE (DC3)
^T	DEVICE CONTROL FOUR (DC4)
^U	NEGATIVE ACKNOWLEDGE (NAK)
^V	SYNCHRONOUS IDLE (SYN)
^W	END OF TRANSMISSION BLOCK (ETB)
^X	CANCEL (CAN)
^Y	END OF MEDIUM (EM)
^Z	SUBSTITUTE (SUB)
^[	ESCAPE (ESC)
^\	FILE SEPARATOR (IS4)
^]	GROUP SEPARATOR (IS3)
^^	RECORD SEPARATOR (IS2)
^_	UNIT SEPARATOR (IS1)
	SPACE
#	NUMBER SIGN
$	DOLLAR SIGN
@	COMMERCIAL AT
[	LEFT SQUARE BRACKET
\	REVERSE SOLIDUS
]	RIGHT SQUARE BRACKET
^	CIRCUMFLEX ACCENT
`	GRAVE ACCENT
{	LEFT CURLY BRACKET
|	VERTICAL LINE
}	RIGHT CURLY BRACKET
~	TILDE
^?	DELETE (DEL)
~@	PADDING CHARACTER (PAD)
~A	HIGH OCTET PRESET (HOP)
~B	BREAK PERMITTED HERE (BPH)
~C	NO BREAK HERE (NBH)
~D	INDEX (IND)
~E	NEXT LINE (NEL)
~F	START OF SELECTED AREA (SSA)
~G	END OF SELECTED AREA (ESA)
~H	CHARACTER TABULATION SET (HTS)
~I	CHARACTER TABULATION WITH JUSTIFICATION (HTJ)
~J	LINE TABULATION SET (VTS)
~K	PARTIAL LINE FORWARD (PLD)
~L	PARTIAL LINE BACKWARD (PLU)
~M	REVERSE LINE FEED (RI)
~N	SINGLE-SHIFT TWO (SS2)
~O	SINGLE-SHIFT THREE (SS3)
~P	DEVICE CONTROL STRING (DCS)
~Q	PRIVATE USE ONE (PU1)
~R	PRIVATE USE TWO (PU2)
~S	SET TRANSMIT STATE (STS)
~T	CANCEL CHARACTER (CCH)
~U	MESSAGE WAITING (MW)
~V	START OF GUARDED AREA (SPA)
~W	END OF GUARDED AREA (EPA)
~X	START OF STRING (SOS)
~Y	SINGLE GRAPHIC CHARACTER INTRODUCER (SGCI)
~Z	SINGLE CHARACTER INTRODUCER (SCI)
~[	CONTROL SEQUENCE INTRODUCER (CSI)
~\	STRING TERMINATOR (ST)
~]	OPERATING SYSTEM COMMAND (OSC)
~^	PRIVACY MESSAGE (PM)
~_	APPLICATION PROGRAM COMMAND (APC)
|	NO-BREAK SPACE
¡	INVERTED EXCLAMATION MARK
¢	CENT SIGN
£	POUND SIGN
¤	CURRENCY SIGN
¥	YEN SIGN
¦	BROKEN BAR
§	SECTION SIGN
¨	DIAERESIS
©	COPYRIGHT SIGN
ª	FEMININE ORDINAL INDICATOR
«	LEFT-POINTING DOUBLE ANGLE QUOTATION MARK
¬	NOT SIGN
­	SOFT HYPHEN
®	REGISTERED SIGN
¯	MACRON
°	DEGREE SIGN
±	PLUS-MINUS SIGN
²	SUPERSCRIPT TWO
³	SUPERSCRIPT THREE
´	ACUTE ACCENT
µ	MICRO SIGN
¶	PILCROW SIGN
·	MIDDLE DOT
¸	CEDILLA
¹	SUPERSCRIPT ONE
º	MASCULINE ORDINAL INDICATOR
»	RIGHT-POINTING DOUBLE ANGLE QUOTATION MARK
¼	VULGAR FRACTION ONE QUARTER
½	VULGAR FRACTION ONE HALF
¾	VULGAR FRACTION THREE QUARTERS
¿	INVERTED QUESTION MARK
À	LATIN CAPITAL LETTER A WITH GRAVE
Á	LATIN CAPITAL LETTER A WITH ACUTE
Â	LATIN CAPITAL LETTER A WITH CIRCUMFLEX
Ã	LATIN CAPITAL LETTER A WITH TILDE
Ä	LATIN CAPITAL LETTER A WITH DIAERESIS
Å	LATIN CAPITAL LETTER A WITH RING ABOVE
Æ	LATIN CAPITAL LETTER AE
Ç	LATIN CAPITAL LETTER C WITH CEDILLA
È	LATIN CAPITAL LETTER E WITH GRAVE
É	LATIN CAPITAL LETTER E WITH ACUTE
Ê	LATIN CAPITAL LETTER E WITH CIRCUMFLEX
Ë	LATIN CAPITAL LETTER E WITH DIAERESIS
Ì	LATIN CAPITAL LETTER I WITH GRAVE
Í	LATIN CAPITAL LETTER I WITH ACUTE
Î	LATIN CAPITAL LETTER I WITH CIRCUMFLEX
Ï	LATIN CAPITAL LETTER I WITH DIAERESIS
Ð	LATIN CAPITAL LETTER ETH (Icelandic)
Ñ	LATIN CAPITAL LETTER N WITH TILDE
Ò	LATIN CAPITAL LETTER O WITH GRAVE
Ó	LATIN CAPITAL LETTER O WITH ACUTE
Ô	LATIN CAPITAL LETTER O WITH CIRCUMFLEX
Õ	LATIN CAPITAL LETTER O WITH TILDE
Ö	LATIN CAPITAL LETTER O WITH DIAERESIS
×	MULTIPLICATION SIGN
Ø	LATIN CAPITAL LETTER O WITH STROKE
Ù	LATIN CAPITAL LETTER U WITH GRAVE
Ú	LATIN CAPITAL LETTER U WITH ACUTE
Û	LATIN CAPITAL LETTER U WITH CIRCUMFLEX
Ü	LATIN CAPITAL LETTER U WITH DIAERESIS
Ý	LATIN CAPITAL LETTER Y WITH ACUTE
Þ	LATIN CAPITAL LETTER THORN (Icelandic)
ß	LATIN SMALL LETTER SHARP S (German)
à	LATIN SMALL LETTER A WITH GRAVE
á	LATIN SMALL LETTER A WITH ACUTE
â	LATIN SMALL LETTER A WITH CIRCUMFLEX
ã	LATIN SMALL LETTER A WITH TILDE
ä	LATIN SMALL LETTER A WITH DIAERESIS
å	LATIN SMALL LETTER A WITH RING ABOVE
æ	LATIN SMALL LETTER AE
ç	LATIN SMALL LETTER C WITH CEDILLA
è	LATIN SMALL LETTER E WITH GRAVE
é	LATIN SMALL LETTER E WITH ACUTE
ê	LATIN SMALL LETTER E WITH CIRCUMFLEX
ë	LATIN SMALL LETTER E WITH DIAERESIS
ì	LATIN SMALL LETTER I WITH GRAVE
í	LATIN SMALL LETTER I WITH ACUTE
î	LATIN SMALL LETTER I WITH CIRCUMFLEX
ï	LATIN SMALL LETTER I WITH DIAERESIS
ð	LATIN SMALL LETTER ETH (Icelandic)
ñ	LATIN SMALL LETTER N WITH TILDE
ò	LATIN SMALL LETTER O WITH GRAVE
ó	LATIN SMALL LETTER O WITH ACUTE
ô	LATIN SMALL LETTER O WITH CIRCUMFLEX
õ	LATIN SMALL LETTER O WITH TILDE
ö	LATIN SMALL LETTER O WITH DIAERESIS
÷	DIVISION SIGN
ø	LATIN SMALL LETTER O WITH STROKE
ù	LATIN SMALL LETTER U WITH GRAVE
ú	LATIN SMALL LETTER U WITH ACUTE
û	LATIN SMALL LETTER U WITH CIRCUMFLEX
ü	LATIN SMALL LETTER U WITH DIAERESIS
ý	LATIN SMALL LETTER Y WITH ACUTE
þ	LATIN SMALL LETTER THORN (Icelandic)
ÿ	LATIN SMALL LETTER Y WITH DIAERESIS
Ā	LATIN CAPITAL LETTER A WITH MACRON
ā	LATIN SMALL LETTER A WITH MACRON
Ă	LATIN CAPITAL LETTER A WITH BREVE
ă	LATIN SMALL LETTER A WITH BREVE
Ą	LATIN CAPITAL LETTER A WITH OGONEK
ą	LATIN SMALL LETTER A WITH OGONEK
Ć	LATIN CAPITAL LETTER C WITH ACUTE
ć	LATIN SMALL LETTER C WITH ACUTE
Ĉ	LATIN CAPITAL LETTER C WITH CIRCUMFLEX
ĉ	LATIN SMALL LETTER C WITH CIRCUMFLEX
Ċ	LATIN CAPITAL LETTER C WITH DOT ABOVE
ċ	LATIN SMALL LETTER C WITH DOT ABOVE
Č	LATIN CAPITAL LETTER C WITH CARON
č	LATIN SMALL LETTER C WITH CARON
Ď	LATIN CAPITAL LETTER D WITH CARON
ď	LATIN SMALL LETTER D WITH CARON
Đ	LATIN CAPITAL LETTER D WITH STROKE
đ	LATIN SMALL LETTER D WITH STROKE
Ē	LATIN CAPITAL LETTER E WITH MACRON
ē	LATIN SMALL LETTER E WITH MACRON
Ĕ	LATIN CAPITAL LETTER E WITH BREVE
ĕ	LATIN SMALL LETTER E WITH BREVE
Ė	LATIN CAPITAL LETTER E WITH DOT ABOVE
ė	LATIN SMALL LETTER E WITH DOT ABOVE
Ę	LATIN CAPITAL LETTER E WITH OGONEK
ę	LATIN SMALL LETTER E WITH OGONEK
Ě	LATIN CAPITAL LETTER E WITH CARON
ě	LATIN SMALL LETTER E WITH CARON
Ĝ	LATIN CAPITAL LETTER G WITH CIRCUMFLEX
ĝ	LATIN SMALL LETTER G WITH CIRCUMFLEX
Ğ	LATIN CAPITAL LETTER G WITH BREVE
ğ	LATIN SMALL LETTER G WITH BREVE
Ġ	LATIN CAPITAL LETTER G WITH DOT ABOVE
ġ	LATIN SMALL LETTER G WITH DOT ABOVE
Ģ	LATIN CAPITAL LETTER G WITH CEDILLA
ģ	LATIN SMALL LETTER G WITH CEDILLA
Ĥ	LATIN CAPITAL LETTER H WITH CIRCUMFLEX
ĥ	LATIN SMALL LETTER H WITH CIRCUMFLEX
Ħ	LATIN CAPITAL LETTER H WITH STROKE
ħ	LATIN SMALL LETTER H WITH STROKE
Ĩ	LATIN CAPITAL LETTER I WITH TILDE
ĩ	LATIN SMALL LETTER I WITH TILDE
Ī	LATIN CAPITAL LETTER I WITH MACRON
ī	LATIN SMALL LETTER I WITH MACRON
Ĭ	LATIN CAPITAL LETTER I WITH BREVE
ĭ	LATIN SMALL LETTER I WITH BREVE
Į	LATIN CAPITAL LETTER I WITH OGONEK
į	LATIN SMALL LETTER I WITH OGONEK
İ	LATIN CAPITAL LETTER I WITH DOT ABOVE
ı	LATIN SMALL LETTER DOTLESS I
Ĳ	LATIN CAPITAL LIGATURE IJ
ĳ	LATIN SMALL LIGATURE IJ
Ĵ	LATIN CAPITAL LETTER J WITH CIRCUMFLEX
ĵ	LATIN SMALL LETTER J WITH CIRCUMFLEX
Ķ	LATIN CAPITAL LETTER K WITH CEDILLA
ķ	LATIN SMALL LETTER K WITH CEDILLA
ĸ	LATIN SMALL LETTER KRA
Ĺ	LATIN CAPITAL LETTER L WITH ACUTE
ĺ	LATIN SMALL LETTER L WITH ACUTE
Ļ	LATIN CAPITAL LETTER L WITH CEDILLA
ļ	LATIN SMALL LETTER L WITH CEDILLA
Ľ	LATIN CAPITAL LETTER L WITH CARON
ľ	LATIN SMALL LETTER L WITH CARON
Ŀ	LATIN CAPITAL LETTER L WITH MIDDLE DOT
ŀ	LATIN SMALL LETTER L WITH MIDDLE DOT
Ł	LATIN CAPITAL LETTER L WITH STROKE
ł	LATIN SMALL LETTER L WITH STROKE
Ń	LATIN CAPITAL LETTER N WITH ACUTE `
ń	LATIN SMALL LETTER N WITH ACUTE `
Ņ	LATIN CAPITAL LETTER N WITH CEDILLA `
ņ	LATIN SMALL LETTER N WITH CEDILLA `
Ň	LATIN CAPITAL LETTER N WITH CARON `
ň	LATIN SMALL LETTER N WITH CARON `
ŉ	LATIN SMALL LETTER N PRECEDED BY APOSTROPHE `
Ŋ	LATIN CAPITAL LETTER ENG
ŋ	LATIN SMALL LETTER ENG
Ō	LATIN CAPITAL LETTER O WITH MACRON
ō	LATIN SMALL LETTER O WITH MACRON
Ŏ	LATIN CAPITAL LETTER O WITH BREVE
ŏ	LATIN SMALL LETTER O WITH BREVE
Ő	LATIN CAPITAL LETTER O WITH DOUBLE ACUTE
ő	LATIN SMALL LETTER O WITH DOUBLE ACUTE
Œ	LATIN CAPITAL LIGATURE OE
œ	LATIN SMALL LIGATURE OE
Ŕ	LATIN CAPITAL LETTER R WITH ACUTE
ŕ	LATIN SMALL LETTER R WITH ACUTE
Ŗ	LATIN CAPITAL LETTER R WITH CEDILLA
ŗ	LATIN SMALL LETTER R WITH CEDILLA
Ř	LATIN CAPITAL LETTER R WITH CARON
ř	LATIN SMALL LETTER R WITH CARON
Ś	LATIN CAPITAL LETTER S WITH ACUTE
ś	LATIN SMALL LETTER S WITH ACUTE
Ŝ	LATIN CAPITAL LETTER S WITH CIRCUMFLEX
ŝ	LATIN SMALL LETTER S WITH CIRCUMFLEX
Ş	LATIN CAPITAL LETTER S WITH CEDILLA
ş	LATIN SMALL LETTER S WITH CEDILLA
Š	LATIN CAPITAL LETTER S WITH CARON
š	LATIN SMALL LETTER S WITH CARON
Ţ	LATIN CAPITAL LETTER T WITH CEDILLA
ţ	LATIN SMALL LETTER T WITH CEDILLA
Ť	LATIN CAPITAL LETTER T WITH CARON
ť	LATIN SMALL LETTER T WITH CARON
Ŧ	LATIN CAPITAL LETTER T WITH STROKE
ŧ	LATIN SMALL LETTER T WITH STROKE
Ũ	LATIN CAPITAL LETTER U WITH TILDE
ũ	LATIN SMALL LETTER U WITH TILDE
Ū	LATIN CAPITAL LETTER U WITH MACRON
ū	LATIN SMALL LETTER U WITH MACRON
Ŭ	LATIN CAPITAL LETTER U WITH BREVE
ŭ	LATIN SMALL LETTER U WITH BREVE
Ů	LATIN CAPITAL LETTER U WITH RING ABOVE
ů	LATIN SMALL LETTER U WITH RING ABOVE
Ű	LATIN CAPITAL LETTER U WITH DOUBLE ACUTE
ű	LATIN SMALL LETTER U WITH DOUBLE ACUTE
Ų	LATIN CAPITAL LETTER U WITH OGONEK
ų	LATIN SMALL LETTER U WITH OGONEK
Ŵ	LATIN CAPITAL LETTER W WITH CIRCUMFLEX
ŵ	LATIN SMALL LETTER W WITH CIRCUMFLEX
Ŷ	LATIN CAPITAL LETTER Y WITH CIRCUMFLEX
ŷ	LATIN SMALL LETTER Y WITH CIRCUMFLEX
Ÿ	LATIN CAPITAL LETTER Y WITH DIAERESIS
Ź	LATIN CAPITAL LETTER Z WITH ACUTE
ź	LATIN SMALL LETTER Z WITH ACUTE
Ż	LATIN CAPITAL LETTER Z WITH DOT ABOVE
ż	LATIN SMALL LETTER Z WITH DOT ABOVE
Ž	LATIN CAPITAL LETTER Z WITH CARON
ž	LATIN SMALL LETTER Z WITH CARON
Ơ	LATIN CAPITAL LETTER O WITH HORN
ơ	LATIN SMALL LETTER O WITH HORN
Ƣ	LATIN CAPITAL LETTER OI
ƣ	LATIN SMALL LETTER OI
Ʀ	LATIN LETTER YR
Ư	LATIN CAPITAL LETTER U WITH HORN
ư	LATIN SMALL LETTER U WITH HORN
Ƶ	LATIN CAPITAL LETTER Z WITH STROKE
ƶ	LATIN SMALL LETTER Z WITH STROKE
Ʒ	LATIN CAPITAL LETTER EZH
Ǎ	LATIN CAPITAL LETTER A WITH CARON
ǎ	LATIN SMALL LETTER A WITH CARON
Ǐ	LATIN CAPITAL LETTER I WITH CARON
ǐ	LATIN SMALL LETTER I WITH CARON
Ǒ	LATIN CAPITAL LETTER O WITH CARON
ǒ	LATIN SMALL LETTER O WITH CARON
Ǔ	LATIN CAPITAL LETTER U WITH CARON
ǔ	LATIN SMALL LETTER U WITH CARON
Ǟ	LATIN CAPITAL LETTER A WITH DIAERESIS AND MACRON
ǟ	LATIN SMALL LETTER A WITH DIAERESIS AND MACRON
Ǡ	LATIN CAPITAL LETTER A WITH DOT ABOVE AND MACRON
ǡ	LATIN SMALL LETTER A WITH DOT ABOVE AND MACRON
Ǣ	LATIN CAPITAL LETTER AE WITH MACRON
ǣ	LATIN SMALL LETTER AE WITH MACRON
Ǥ	LATIN CAPITAL LETTER G WITH STROKE
ǥ	LATIN SMALL LETTER G WITH STROKE
Ǧ	LATIN CAPITAL LETTER G WITH CARON
ǧ	LATIN SMALL LETTER G WITH CARON
Ǩ	LATIN CAPITAL LETTER K WITH CARON
ǩ	LATIN SMALL LETTER K WITH CARON
Ǫ	LATIN CAPITAL LETTER O WITH OGONEK
ǫ	LATIN SMALL LETTER O WITH OGONEK
Ǭ	LATIN CAPITAL LETTER O WITH OGONEK AND MACRON
ǭ	LATIN SMALL LETTER O WITH OGONEK AND MACRON
Ǯ	LATIN CAPITAL LETTER EZH WITH CARON
ǯ	LATIN SMALL LETTER EZH WITH CARON
ǰ	LATIN SMALL LETTER J WITH CARON
Ǵ	LATIN CAPITAL LETTER G WITH ACUTE
ǵ	LATIN SMALL LETTER G WITH ACUTE
ʿ	MODIFIER LETTER LEFT HALF RING
ˇ	CARON
˘	BREVE
˙	DOT ABOVE
˚	RING ABOVE
˛	OGONEK
˝	DOUBLE ACUTE ACCENT
Ά	GREEK CAPITAL LETTER ALPHA WITH TONOS
Έ	GREEK CAPITAL LETTER EPSILON WITH TONOS
Ή	GREEK CAPITAL LETTER ETA WITH TONOS
Ί	GREEK CAPITAL LETTER IOTA WITH TONOS
Ό	GREEK CAPITAL LETTER OMICRON WITH TONOS
Ύ	GREEK CAPITAL LETTER UPSILON WITH TONOS
Ώ	GREEK CAPITAL LETTER OMEGA WITH TONOS
ΐ	GREEK SMALL LETTER IOTA WITH DIALYTIKA AND TONOS
Α	GREEK CAPITAL LETTER ALPHA
Β	GREEK CAPITAL LETTER BETA
Γ	GREEK CAPITAL LETTER GAMMA
Δ	GREEK CAPITAL LETTER DELTA
Ε	GREEK CAPITAL LETTER EPSILON
Ζ	GREEK CAPITAL LETTER ZETA
Η	GREEK CAPITAL LETTER ETA
Θ	GREEK CAPITAL LETTER THETA
Ι	GREEK CAPITAL LETTER IOTA
Κ	GREEK CAPITAL LETTER KAPPA
Λ	GREEK CAPITAL LETTER LAMDA
Μ	GREEK CAPITAL LETTER MU
Ν	GREEK CAPITAL LETTER NU
Ξ	GREEK CAPITAL LETTER XI
Ο	GREEK CAPITAL LETTER OMICRON
Π	GREEK CAPITAL LETTER PI
Ρ	GREEK CAPITAL LETTER RHO
Σ	GREEK CAPITAL LETTER SIGMA
Τ	GREEK CAPITAL LETTER TAU
Υ	GREEK CAPITAL LETTER UPSILON
Φ	GREEK CAPITAL LETTER PHI
Χ	GREEK CAPITAL LETTER CHI
Ψ	GREEK CAPITAL LETTER PSI
Ω	GREEK CAPITAL LETTER OMEGA
Ϊ	GREEK CAPITAL LETTER IOTA WITH DIALYTIKA
Ϋ	GREEK CAPITAL LETTER UPSILON WITH DIALYTIKA
ά	GREEK SMALL LETTER ALPHA WITH TONOS
έ	GREEK SMALL LETTER EPSILON WITH TONOS
ή	GREEK SMALL LETTER ETA WITH TONOS
ί	GREEK SMALL LETTER IOTA WITH TONOS
ΰ	GREEK SMALL LETTER UPSILON WITH DIALYTIKA AND TONOS
α	GREEK SMALL LETTER ALPHA
β	GREEK SMALL LETTER BETA
γ	GREEK SMALL LETTER GAMMA
δ	GREEK SMALL LETTER DELTA
ε	GREEK SMALL LETTER EPSILON
ζ	GREEK SMALL LETTER ZETA
η	GREEK SMALL LETTER ETA
θ	GREEK SMALL LETTER THETA
ι	GREEK SMALL LETTER IOTA
κ	GREEK SMALL LETTER KAPPA
λ	GREEK SMALL LETTER LAMDA
μ	GREEK SMALL LETTER MU
ν	GREEK SMALL LETTER NU
ξ	GREEK SMALL LETTER XI
ο	GREEK SMALL LETTER OMICRON
π	GREEK SMALL LETTER PI
ρ	GREEK SMALL LETTER RHO
ς	GREEK SMALL LETTER FINAL SIGMA
σ	GREEK SMALL LETTER SIGMA
τ	GREEK SMALL LETTER TAU
υ	GREEK SMALL LETTER UPSILON
φ	GREEK SMALL LETTER PHI
χ	GREEK SMALL LETTER CHI
ψ	GREEK SMALL LETTER PSI
ω	GREEK SMALL LETTER OMEGA
ϊ	GREEK SMALL LETTER IOTA WITH DIALYTIKA
ϋ	GREEK SMALL LETTER UPSILON WITH DIALYTIKA
ό	GREEK SMALL LETTER OMICRON WITH TONOS
ύ	GREEK SMALL LETTER UPSILON WITH TONOS
ώ	GREEK SMALL LETTER OMEGA WITH TONOS
Ϙ	GREEK LETTER ARCHAIC KOPPA
ϙ	GREEK SMALL LETTER ARCHAIC KOPPA
Ϛ	GREEK LETTER STIGMA
ϛ	GREEK SMALL LETTER STIGMA
Ϝ	GREEK LETTER DIGAMMA
ϝ	GREEK SMALL LETTER DIGAMMA
Ϟ	GREEK LETTER KOPPA
ϟ	GREEK SMALL LETTER KOPPA
Ϡ	GREEK LETTER SAMPI
ϡ	GREEK SMALL LETTER SAMPI
ϴ	GREEK CAPITAL THETA SYMBOL
ϵ	GREEK LUNATE EPSILON SYMBOL
Ё	CYRILLIC CAPITAL LETTER IO
Ђ	CYRILLIC CAPITAL LETTER DJE
Ѓ	CYRILLIC CAPITAL LETTER GJE
Є	CYRILLIC CAPITAL LETTER UKRAINIAN IE
Ѕ	CYRILLIC CAPITAL LETTER DZE
І	CYRILLIC CAPITAL LETTER BYELORUSSIAN-UKRAINIAN I
Ї	CYRILLIC CAPITAL LETTER YI
Ј	CYRILLIC CAPITAL LETTER JE
Љ	CYRILLIC CAPITAL LETTER LJE
Њ	CYRILLIC CAPITAL LETTER NJE
Ћ	CYRILLIC CAPITAL LETTER TSHE
Ќ	CYRILLIC CAPITAL LETTER KJE
Ў	CYRILLIC CAPITAL LETTER SHORT U
Џ	CYRILLIC CAPITAL LETTER DZHE
А	CYRILLIC CAPITAL LETTER A
Б	CYRILLIC CAPITAL LETTER BE
В	CYRILLIC CAPITAL LETTER VE
Г	CYRILLIC CAPITAL LETTER GHE
Д	CYRILLIC CAPITAL LETTER DE
Е	CYRILLIC CAPITAL LETTER IE
Ж	CYRILLIC CAPITAL LETTER ZHE
З	CYRILLIC CAPITAL LETTER ZE
И	CYRILLIC CAPITAL LETTER I
Й	CYRILLIC CAPITAL LETTER SHORT I
К	CYRILLIC CAPITAL LETTER KA
Л	CYRILLIC CAPITAL LETTER EL
М	CYRILLIC CAPITAL LETTER EM
Н	CYRILLIC CAPITAL LETTER EN
О	CYRILLIC CAPITAL LETTER O
П	CYRILLIC CAPITAL LETTER PE
Р	CYRILLIC CAPITAL LETTER ER
С	CYRILLIC CAPITAL LETTER ES
Т	CYRILLIC CAPITAL LETTER TE
У	CYRILLIC CAPITAL LETTER U
Ф	CYRILLIC CAPITAL LETTER EF
Х	CYRILLIC CAPITAL LETTER HA
Ц	CYRILLIC CAPITAL LETTER TSE
Ч	CYRILLIC CAPITAL LETTER CHE
Ш	CYRILLIC CAPITAL LETTER SHA
Щ	CYRILLIC CAPITAL LETTER SHCHA
Ъ	CYRILLIC CAPITAL LETTER HARD SIGN
Ы	CYRILLIC CAPITAL LETTER YERU
Ь	CYRILLIC CAPITAL LETTER SOFT SIGN
Э	CYRILLIC CAPITAL LETTER E
Ю	CYRILLIC CAPITAL LETTER YU
Я	CYRILLIC CAPITAL LETTER YA
а	CYRILLIC SMALL LETTER A
б	CYRILLIC SMALL LETTER BE
в	CYRILLIC SMALL LETTER VE
г	CYRILLIC SMALL LETTER GHE
д	CYRILLIC SMALL LETTER DE
е	CYRILLIC SMALL LETTER IE
ж	CYRILLIC SMALL LETTER ZHE
з	CYRILLIC SMALL LETTER ZE
и	CYRILLIC SMALL LETTER I
й	CYRILLIC SMALL LETTER SHORT I
к	CYRILLIC SMALL LETTER KA
л	CYRILLIC SMALL LETTER EL
м	CYRILLIC SMALL LETTER EM
н	CYRILLIC SMALL LETTER EN
о	CYRILLIC SMALL LETTER O
п	CYRILLIC SMALL LETTER PE
р	CYRILLIC SMALL LETTER ER
с	CYRILLIC SMALL LETTER ES
т	CYRILLIC SMALL LETTER TE
у	CYRILLIC SMALL LETTER U
ф	CYRILLIC SMALL LETTER EF
х	CYRILLIC SMALL LETTER HA
ц	CYRILLIC SMALL LETTER TSE
ч	CYRILLIC SMALL LETTER CHE
ш	CYRILLIC SMALL LETTER SHA
щ	CYRILLIC SMALL LETTER SHCHA
ъ	CYRILLIC SMALL LETTER HARD SIGN
ы	CYRILLIC SMALL LETTER YERU
ь	CYRILLIC SMALL LETTER SOFT SIGN
э	CYRILLIC SMALL LETTER E
ю	CYRILLIC SMALL LETTER YU
я	CYRILLIC SMALL LETTER YA
ё	CYRILLIC SMALL LETTER IO
ђ	CYRILLIC SMALL LETTER DJE
ѓ	CYRILLIC SMALL LETTER GJE
є	CYRILLIC SMALL LETTER UKRAINIAN IE
ѕ	CYRILLIC SMALL LETTER DZE
і	CYRILLIC SMALL LETTER BYELORUSSIAN-UKRAINIAN I
ї	CYRILLIC SMALL LETTER YI
ј	CYRILLIC SMALL LETTER JE
љ	CYRILLIC SMALL LETTER LJE
њ	CYRILLIC SMALL LETTER NJE
ћ	CYRILLIC SMALL LETTER TSHE
ќ	CYRILLIC SMALL LETTER KJE
ў	CYRILLIC SMALL LETTER SHORT U
џ	CYRILLIC SMALL LETTER DZHE
Ѣ	CYRILLIC CAPITAL LETTER YAT
ѣ	CYRILLIC SMALL LETTER YAT
Ѫ	CYRILLIC CAPITAL LETTER BIG YUS
ѫ	CYRILLIC SMALL LETTER BIG YUS
Ѳ	CYRILLIC CAPITAL LETTER FITA
ѳ	CYRILLIC SMALL LETTER FITA
Ѵ	CYRILLIC CAPITAL LETTER IZHITSA
ѵ	CYRILLIC SMALL LETTER IZHITSA
Ҁ	CYRILLIC CAPITAL LETTER KOPPA
ҁ	CYRILLIC SMALL LETTER KOPPA
Ґ	CYRILLIC CAPITAL LETTER GHE WITH UPTURN
ґ	CYRILLIC SMALL LETTER GHE WITH UPTURN
א	HEBREW LETTER ALEF
ב	HEBREW LETTER BET
ג	HEBREW LETTER GIMEL
ד	HEBREW LETTER DALET
ה	HEBREW LETTER HE
ו	HEBREW LETTER VAV
ז	HEBREW LETTER ZAYIN
ח	HEBREW LETTER HET
ט	HEBREW LETTER TET
י	HEBREW LETTER YOD
ך	HEBREW LETTER FINAL KAF
כ	HEBREW LETTER KAF
ל	HEBREW LETTER LAMED
ם	HEBREW LETTER FINAL MEM
מ	HEBREW LETTER MEM
ן	HEBREW LETTER FINAL NUN `
נ	HEBREW LETTER NUN `
ס	HEBREW LETTER SAMEKH
ע	HEBREW LETTER AYIN
ף	HEBREW LETTER FINAL PE
פ	HEBREW LETTER PE
ץ	HEBREW LETTER FINAL TSADI
צ	HEBREW LETTER TSADI
ק	HEBREW LETTER QOF
ר	HEBREW LETTER RESH
ש	HEBREW LETTER SHIN
ת	HEBREW LETTER TAV
،	ARABIC COMMA
؛	ARABIC SEMICOLON
؟	ARABIC QUESTION MARK
ء	ARABIC LETTER HAMZA
آ	ARABIC LETTER ALEF WITH MADDA ABOVE
أ	ARABIC LETTER ALEF WITH HAMZA ABOVE
ؤ	ARABIC LETTER WAW WITH HAMZA ABOVE
إ	ARABIC LETTER ALEF WITH HAMZA BELOW
ئ	ARABIC LETTER YEH WITH HAMZA ABOVE
ا	ARABIC LETTER ALEF
ب	ARABIC LETTER BEH
ة	ARABIC LETTER TEH MARBUTA
ت	ARABIC LETTER TEH
ث	ARABIC LETTER THEH
ج	ARABIC LETTER JEEM
ح	ARABIC LETTER HAH
خ	ARABIC LETTER KHAH
د	ARABIC LETTER DAL
ذ	ARABIC LETTER THAL
ر	ARABIC LETTER REH
ز	ARABIC LETTER ZAIN
س	ARABIC LETTER SEEN
ش	ARABIC LETTER SHEEN
ص	ARABIC LETTER SAD
ض	ARABIC LETTER DAD
ط	ARABIC LETTER TAH
ظ	ARABIC LETTER ZAH
ع	ARABIC LETTER AIN
غ	ARABIC LETTER GHAIN
ـ	ARABIC TATWEEL
ف	ARABIC LETTER FEH
ق	ARABIC LETTER QAF
ك	ARABIC LETTER KAF
ل	ARABIC LETTER LAM
م	ARABIC LETTER MEEM
ن	ARABIC LETTER NOON
ه	ARABIC LETTER HEH
و	ARABIC LETTER WAW
ى	ARABIC LETTER ALEF MAKSURA
ي	ARABIC LETTER YEH
ً	ARABIC FATHATAN
ٌ	ARABIC DAMMATAN
ٍ	ARABIC KASRATAN
َ	ARABIC FATHA
ُ	ARABIC DAMMA
ِ	ARABIC KASRA
ّ	ARABIC SHADDA
ْ	ARABIC SUKUN
ٰ	ARABIC LETTER SUPERSCRIPT ALEF
پ	ARABIC LETTER PEH
ڤ	ARABIC LETTER VEH
گ	ARABIC LETTER GAF
۰	EXTENDED ARABIC-INDIC DIGIT ZERO
۱	EXTENDED ARABIC-INDIC DIGIT ONE
۲	EXTENDED ARABIC-INDIC DIGIT TWO
۳	EXTENDED ARABIC-INDIC DIGIT THREE
۴	EXTENDED ARABIC-INDIC DIGIT FOUR
۵	EXTENDED ARABIC-INDIC DIGIT FIVE
۶	EXTENDED ARABIC-INDIC DIGIT SIX
۷	EXTENDED ARABIC-INDIC DIGIT SEVEN
۸	EXTENDED ARABIC-INDIC DIGIT EIGHT
۹	EXTENDED ARABIC-INDIC DIGIT NINE
Ḃ	LATIN CAPITAL LETTER B WITH DOT ABOVE
ḃ	LATIN SMALL LETTER B WITH DOT ABOVE
Ḇ	LATIN CAPITAL LETTER B WITH LINE BELOW
ḇ	LATIN SMALL LETTER B WITH LINE BELOW
Ḋ	LATIN CAPITAL LETTER D WITH DOT ABOVE
ḋ	LATIN SMALL LETTER D WITH DOT ABOVE
Ḏ	LATIN CAPITAL LETTER D WITH LINE BELOW
ḏ	LATIN SMALL LETTER D WITH LINE BELOW
Ḑ	LATIN CAPITAL LETTER D WITH CEDILLA
ḑ	LATIN SMALL LETTER D WITH CEDILLA
Ḟ	LATIN CAPITAL LETTER F WITH DOT ABOVE
ḟ	LATIN SMALL LETTER F WITH DOT ABOVE
Ḡ	LATIN CAPITAL LETTER G WITH MACRON
ḡ	LATIN SMALL LETTER G WITH MACRON
Ḣ	LATIN CAPITAL LETTER H WITH DOT ABOVE
ḣ	LATIN SMALL LETTER H WITH DOT ABOVE
Ḧ	LATIN CAPITAL LETTER H WITH DIAERESIS
ḧ	LATIN SMALL LETTER H WITH DIAERESIS
Ḩ	LATIN CAPITAL LETTER H WITH CEDILLA
ḩ	LATIN SMALL LETTER H WITH CEDILLA
Ḱ	LATIN CAPITAL LETTER K WITH ACUTE
ḱ	LATIN SMALL LETTER K WITH ACUTE
Ḵ	LATIN CAPITAL LETTER K WITH LINE BELOW
ḵ	LATIN SMALL LETTER K WITH LINE BELOW
Ḻ	LATIN CAPITAL LETTER L WITH LINE BELOW
ḻ	LATIN SMALL LETTER L WITH LINE BELOW
Ḿ	LATIN CAPITAL LETTER M WITH ACUTE
ḿ	LATIN SMALL LETTER M WITH ACUTE
Ṁ	LATIN CAPITAL LETTER M WITH DOT ABOVE
ṁ	LATIN SMALL LETTER M WITH DOT ABOVE
Ṅ	LATIN CAPITAL LETTER N WITH DOT ABOVE `
ṅ	LATIN SMALL LETTER N WITH DOT ABOVE `
Ṉ	LATIN CAPITAL LETTER N WITH LINE BELOW `
ṉ	LATIN SMALL LETTER N WITH LINE BELOW `
Ṕ	LATIN CAPITAL LETTER P WITH ACUTE
ṕ	LATIN SMALL LETTER P WITH ACUTE
Ṗ	LATIN CAPITAL LETTER P WITH DOT ABOVE
ṗ	LATIN SMALL LETTER P WITH DOT ABOVE
Ṙ	LATIN CAPITAL LETTER R WITH DOT ABOVE
ṙ	LATIN SMALL LETTER R WITH DOT ABOVE
Ṟ	LATIN CAPITAL LETTER R WITH LINE BELOW
ṟ	LATIN SMALL LETTER R WITH LINE BELOW
Ṡ	LATIN CAPITAL LETTER S WITH DOT ABOVE
ṡ	LATIN SMALL LETTER S WITH DOT ABOVE
Ṫ	LATIN CAPITAL LETTER T WITH DOT ABOVE
ṫ	LATIN SMALL LETTER T WITH DOT ABOVE
Ṯ	LATIN CAPITAL LETTER T WITH LINE BELOW
ṯ	LATIN SMALL LETTER T WITH LINE BELOW
Ṽ	LATIN CAPITAL LETTER V WITH TILDE
ṽ	LATIN SMALL LETTER V WITH TILDE
Ẁ	LATIN CAPITAL LETTER W WITH GRAVE
ẁ	LATIN SMALL LETTER W WITH GRAVE
Ẃ	LATIN CAPITAL LETTER W WITH ACUTE
ẃ	LATIN SMALL LETTER W WITH ACUTE
Ẅ	LATIN CAPITAL LETTER W WITH DIAERESIS
ẅ	LATIN SMALL LETTER W WITH DIAERESIS
Ẇ	LATIN CAPITAL LETTER W WITH DOT ABOVE
ẇ	LATIN SMALL LETTER W WITH DOT ABOVE
Ẋ	LATIN CAPITAL LETTER X WITH DOT ABOVE
ẋ	LATIN SMALL LETTER X WITH DOT ABOVE
Ẍ	LATIN CAPITAL LETTER X WITH DIAERESIS
ẍ	LATIN SMALL LETTER X WITH DIAERESIS
Ẏ	LATIN CAPITAL LETTER Y WITH DOT ABOVE
ẏ	LATIN SMALL LETTER Y WITH DOT ABOVE
Ẑ	LATIN CAPITAL LETTER Z WITH CIRCUMFLEX
ẑ	LATIN SMALL LETTER Z WITH CIRCUMFLEX
Ẕ	LATIN CAPITAL LETTER Z WITH LINE BELOW
ẕ	LATIN SMALL LETTER Z WITH LINE BELOW
ẖ	LATIN SMALL LETTER H WITH LINE BELOW
ẗ	LATIN SMALL LETTER T WITH DIAERESIS
ẘ	LATIN SMALL LETTER W WITH RING ABOVE
ẙ	LATIN SMALL LETTER Y WITH RING ABOVE
Ả	LATIN CAPITAL LETTER A WITH HOOK ABOVE
ả	LATIN SMALL LETTER A WITH HOOK ABOVE
Ẻ	LATIN CAPITAL LETTER E WITH HOOK ABOVE
ẻ	LATIN SMALL LETTER E WITH HOOK ABOVE
Ẽ	LATIN CAPITAL LETTER E WITH TILDE
ẽ	LATIN SMALL LETTER E WITH TILDE
Ỉ	LATIN CAPITAL LETTER I WITH HOOK ABOVE
ỉ	LATIN SMALL LETTER I WITH HOOK ABOVE
Ỏ	LATIN CAPITAL LETTER O WITH HOOK ABOVE
ỏ	LATIN SMALL LETTER O WITH HOOK ABOVE
Ủ	LATIN CAPITAL LETTER U WITH HOOK ABOVE
ủ	LATIN SMALL LETTER U WITH HOOK ABOVE
Ỳ	LATIN CAPITAL LETTER Y WITH GRAVE
ỳ	LATIN SMALL LETTER Y WITH GRAVE
Ỷ	LATIN CAPITAL LETTER Y WITH HOOK ABOVE
ỷ	LATIN SMALL LETTER Y WITH HOOK ABOVE
Ỹ	LATIN CAPITAL LETTER Y WITH TILDE
ỹ	LATIN SMALL LETTER Y WITH TILDE
ἀ	GREEK SMALL LETTER ALPHA WITH PSILI
ἁ	GREEK SMALL LETTER ALPHA WITH DASIA
ἂ	GREEK SMALL LETTER ALPHA WITH PSILI AND VARIA
ἃ	GREEK SMALL LETTER ALPHA WITH DASIA AND VARIA
ἄ	GREEK SMALL LETTER ALPHA WITH PSILI AND OXIA
ἅ	GREEK SMALL LETTER ALPHA WITH DASIA AND OXIA
ἆ	GREEK SMALL LETTER ALPHA WITH PSILI AND PERISPOMENI
ἇ	GREEK SMALL LETTER ALPHA WITH DASIA AND PERISPOMENI
 	EN SPACE
 	EM SPACE
 	THREE-PER-EM SPACE
 	FOUR-PER-EM SPACE
 	SIX-PER-EM SPACE
 	THIN SPACE
 	HAIR SPACE
‐	HYPHEN
–	EN DASH `
—	EM DASH
―	HORIZONTAL BAR
‖	DOUBLE VERTICAL LINE
‗	DOUBLE LOW LINE
‘	LEFT SINGLE QUOTATION MARK
’	RIGHT SINGLE QUOTATION MARK
‚	SINGLE LOW-9 QUOTATION MARK
‛	SINGLE HIGH-REVERSED-9 QUOTATION MARK
“	LEFT DOUBLE QUOTATION MARK
”	RIGHT DOUBLE QUOTATION MARK
„	DOUBLE LOW-9 QUOTATION MARK
‟	DOUBLE HIGH-REVERSED-9 QUOTATION MARK
†	DAGGER
‡	DOUBLE DAGGER
•	BULLET
‥	TWO DOT LEADER
…	HORIZONTAL ELLIPSIS
‰	PER MILLE SIGN
′	PRIME
″	DOUBLE PRIME
‴	TRIPLE PRIME
‵	REVERSED PRIME
‶	REVERSED DOUBLE PRIME
‷	REVERSED TRIPLE PRIME
‸	CARET
‹	SINGLE LEFT-POINTING ANGLE QUOTATION MARK
›	SINGLE RIGHT-POINTING ANGLE QUOTATION MARK
※	REFERENCE MARK
‾	OVERLINE
⁄	FRACTION SLASH
⁰	SUPERSCRIPT ZERO
⁴	SUPERSCRIPT FOUR
⁵	SUPERSCRIPT FIVE
⁶	SUPERSCRIPT SIX
⁷	SUPERSCRIPT SEVEN
⁸	SUPERSCRIPT EIGHT
⁹	SUPERSCRIPT NINE
⁺	SUPERSCRIPT PLUS SIGN
⁻	SUPERSCRIPT MINUS
⁼	SUPERSCRIPT EQUALS SIGN
⁽	SUPERSCRIPT LEFT PARENTHESIS
⁾	SUPERSCRIPT RIGHT PARENTHESIS
ⁿ	SUPERSCRIPT LATIN SMALL LETTER N `
₀	SUBSCRIPT ZERO
₁	SUBSCRIPT ONE
₂	SUBSCRIPT TWO
₃	SUBSCRIPT THREE
₄	SUBSCRIPT FOUR
₅	SUBSCRIPT FIVE
₆	SUBSCRIPT SIX
₇	SUBSCRIPT SEVEN
₈	SUBSCRIPT EIGHT
₉	SUBSCRIPT NINE
₊	SUBSCRIPT PLUS SIGN
₋	SUBSCRIPT MINUS
₌	SUBSCRIPT EQUALS SIGN
₍	SUBSCRIPT LEFT PARENTHESIS
₎	SUBSCRIPT RIGHT PARENTHESIS
₤	LIRA SIGN
₧	PESETA SIGN
₩	WON SIGN
€	EURO SIGN
₽	ROUBLE SIGN
₽	ROUBLE SIGN
℃	DEGREE CELSIUS
℅	CARE OF
℉	DEGREE FAHRENHEIT
№	NUMERO SIGN
℗	SOUND RECORDING COPYRIGHT
℞	PRESCRIPTION TAKE
℠	SERVICE MARK
™	TRADE MARK SIGN
Ω	OHM SIGN
Å	ANGSTROM SIGN
⅓	VULGAR FRACTION ONE THIRD
⅔	VULGAR FRACTION TWO THIRDS
⅕	VULGAR FRACTION ONE FIFTH
⅖	VULGAR FRACTION TWO FIFTHS
⅗	VULGAR FRACTION THREE FIFTHS
⅘	VULGAR FRACTION FOUR FIFTHS
⅙	VULGAR FRACTION ONE SIXTH
⅚	VULGAR FRACTION FIVE SIXTHS
⅛	VULGAR FRACTION ONE EIGHTH
⅜	VULGAR FRACTION THREE EIGHTHS
⅝	VULGAR FRACTION FIVE EIGHTHS
⅞	VULGAR FRACTION SEVEN EIGHTHS
Ⅰ	ROMAN NUMERAL ONE
Ⅱ	ROMAN NUMERAL TWO
Ⅲ	ROMAN NUMERAL THREE
Ⅳ	ROMAN NUMERAL FOUR
Ⅴ	ROMAN NUMERAL FIVE
Ⅵ	ROMAN NUMERAL SIX
Ⅶ	ROMAN NUMERAL SEVEN
Ⅷ	ROMAN NUMERAL EIGHT
Ⅸ	ROMAN NUMERAL NINE
Ⅹ	ROMAN NUMERAL TEN
Ⅺ	ROMAN NUMERAL ELEVEN
Ⅻ	ROMAN NUMERAL TWELVE
ⅰ	SMALL ROMAN NUMERAL ONE
ⅱ	SMALL ROMAN NUMERAL TWO
ⅲ	SMALL ROMAN NUMERAL THREE
ⅳ	SMALL ROMAN NUMERAL FOUR
ⅴ	SMALL ROMAN NUMERAL FIVE
ⅵ	SMALL ROMAN NUMERAL SIX
ⅶ	SMALL ROMAN NUMERAL SEVEN
ⅷ	SMALL ROMAN NUMERAL EIGHT
ⅸ	SMALL ROMAN NUMERAL NINE
ⅹ	SMALL ROMAN NUMERAL TEN
ⅺ	SMALL ROMAN NUMERAL ELEVEN
ⅻ	SMALL ROMAN NUMERAL TWELVE
←	LEFTWARDS ARROW
↑	UPWARDS ARROW
→	RIGHTWARDS ARROW
↓	DOWNWARDS ARROW
↔	LEFT RIGHT ARROW
↕	UP DOWN ARROW
⇐	LEFTWARDS DOUBLE ARROW
⇒	RIGHTWARDS DOUBLE ARROW
⇔	LEFT RIGHT DOUBLE ARROW
∀	FOR ALL
∂	PARTIAL DIFFERENTIAL
∃	THERE EXISTS
∅	EMPTY SET
∆	INCREMENT
∇	NABLA
∈	ELEMENT OF
∋	CONTAINS AS MEMBER
∏	N-ARY PRODUCT `
∑	N-ARY SUMMATION `
−	MINUS SIGN
∓	MINUS-OR-PLUS SIGN
∗	ASTERISK OPERATOR
∘	RING OPERATOR
∙	BULLET OPERATOR
√	SQUARE ROOT
∝	PROPORTIONAL TO
∞	INFINITY
∟	RIGHT ANGLE
∠	ANGLE
∥	PARALLEL TO
∧	LOGICAL AND
∨	LOGICAL OR
∩	INTERSECTION
∪	UNION
∫	INTEGRAL
∬	DOUBLE INTEGRAL
∮	CONTOUR INTEGRAL
∴	THEREFORE
∵	BECAUSE
∶	RATIO
∷	PROPORTION
∼	TILDE OPERATOR
∾	INVERTED LAZY S
≃	ASYMPTOTICALLY EQUAL TO
≅	APPROXIMATELY EQUAL TO
≈	ALMOST EQUAL TO
≌	ALL EQUAL TO
≓	IMAGE OF OR APPROXIMATELY EQUAL TO
≠	NOT EQUAL TO
≡	IDENTICAL TO
≤	LESS-THAN OR EQUAL TO
≥	GREATER-THAN OR EQUAL TO
≪	MUCH LESS-THAN
≫	MUCH GREATER-THAN
≮	NOT LESS-THAN
≯	NOT GREATER-THAN
⊂	SUBSET OF
⊃	SUPERSET OF
⊆	SUBSET OF OR EQUAL TO
⊇	SUPERSET OF OR EQUAL TO
⊙	CIRCLED DOT OPERATOR
⊚	CIRCLED RING OPERATOR
⊥	UP TACK
⋅	DOT OPERATOR
⋮	VERTICAL ELLIPSIS
⋯	MIDLINE HORIZONTAL ELLIPSIS
⌂	HOUSE
⌈	LEFT CEILING
⌉	RIGHT CEILING
⌊	LEFT FLOOR
⌋	RIGHT FLOOR
⌐	REVERSED NOT SIGN
⌒	ARC
⌕	TELEPHONE RECORDER
⌠	TOP HALF INTEGRAL
⌡	BOTTOM HALF INTEGRAL
〈	LEFT-POINTING ANGLE BRACKET
〉	RIGHT-POINTING ANGLE BRACKET
␣	OPEN BOX
⑀	OCR HOOK
⑁	OCR CHAIR
⑂	OCR FORK
⑃	OCR INVERTED FORK
⑆	OCR BRANCH BANK IDENTIFICATION
⑇	OCR AMOUNT OF CHECK
⑈	OCR DASH
⑉	OCR CUSTOMER ACCOUNT NUMBER
⒈	DIGIT ONE FULL STOP
⒉	DIGIT TWO FULL STOP
⒊	DIGIT THREE FULL STOP
⒋	DIGIT FOUR FULL STOP
⒌	DIGIT FIVE FULL STOP
⒍	DIGIT SIX FULL STOP
⒎	DIGIT SEVEN FULL STOP
⒏	DIGIT EIGHT FULL STOP
⒐	DIGIT NINE FULL STOP
─	BOX DRAWINGS LIGHT HORIZONTAL
━	BOX DRAWINGS HEAVY HORIZONTAL
│	BOX DRAWINGS LIGHT VERTICAL
┃	BOX DRAWINGS HEAVY VERTICAL
┄	BOX DRAWINGS LIGHT TRIPLE DASH HORIZONTAL
┅	BOX DRAWINGS HEAVY TRIPLE DASH HORIZONTAL
┆	BOX DRAWINGS LIGHT TRIPLE DASH VERTICAL
┇	BOX DRAWINGS HEAVY TRIPLE DASH VERTICAL
┈	BOX DRAWINGS LIGHT QUADRUPLE DASH HORIZONTAL
┉	BOX DRAWINGS HEAVY QUADRUPLE DASH HORIZONTAL
┊	BOX DRAWINGS LIGHT QUADRUPLE DASH VERTICAL
┋	BOX DRAWINGS HEAVY QUADRUPLE DASH VERTICAL
┌	BOX DRAWINGS LIGHT DOWN AND RIGHT
┍	BOX DRAWINGS DOWN LIGHT AND RIGHT HEAVY
┎	BOX DRAWINGS DOWN HEAVY AND RIGHT LIGHT
┏	BOX DRAWINGS HEAVY DOWN AND RIGHT
┐	BOX DRAWINGS LIGHT DOWN AND LEFT
┑	BOX DRAWINGS DOWN LIGHT AND LEFT HEAVY
┒	BOX DRAWINGS DOWN HEAVY AND LEFT LIGHT
┓	BOX DRAWINGS HEAVY DOWN AND LEFT
└	BOX DRAWINGS LIGHT UP AND RIGHT
┕	BOX DRAWINGS UP LIGHT AND RIGHT HEAVY
┖	BOX DRAWINGS UP HEAVY AND RIGHT LIGHT
┗	BOX DRAWINGS HEAVY UP AND RIGHT
┘	BOX DRAWINGS LIGHT UP AND LEFT
┙	BOX DRAWINGS UP LIGHT AND LEFT HEAVY
┚	BOX DRAWINGS UP HEAVY AND LEFT LIGHT
┛	BOX DRAWINGS HEAVY UP AND LEFT
├	BOX DRAWINGS LIGHT VERTICAL AND RIGHT
┝	BOX DRAWINGS VERTICAL LIGHT AND RIGHT HEAVY
┠	BOX DRAWINGS VERTICAL HEAVY AND RIGHT LIGHT
┣	BOX DRAWINGS HEAVY VERTICAL AND RIGHT
┤	BOX DRAWINGS LIGHT VERTICAL AND LEFT
┥	BOX DRAWINGS VERTICAL LIGHT AND LEFT HEAVY
┨	BOX DRAWINGS VERTICAL HEAVY AND LEFT LIGHT
┫	BOX DRAWINGS HEAVY VERTICAL AND LEFT
┬	BOX DRAWINGS LIGHT DOWN AND HORIZONTAL
┯	BOX DRAWINGS DOWN LIGHT AND HORIZONTAL HEAVY
┰	BOX DRAWINGS DOWN HEAVY AND HORIZONTAL LIGHT
┳	BOX DRAWINGS HEAVY DOWN AND HORIZONTAL
┴	BOX DRAWINGS LIGHT UP AND HORIZONTAL
┷	BOX DRAWINGS UP LIGHT AND HORIZONTAL HEAVY
┸	BOX DRAWINGS UP HEAVY AND HORIZONTAL LIGHT
┻	BOX DRAWINGS HEAVY UP AND HORIZONTAL
┼	BOX DRAWINGS LIGHT VERTICAL AND HORIZONTAL
┿	BOX DRAWINGS VERTICAL LIGHT AND HORIZONTAL HEAVY
╂	BOX DRAWINGS VERTICAL HEAVY AND HORIZONTAL LIGHT
╋	BOX DRAWINGS HEAVY VERTICAL AND HORIZONTAL
╱	BOX DRAWINGS LIGHT DIAGONAL UPPER RIGHT TO LOWER LEFT
╲	BOX DRAWINGS LIGHT DIAGONAL UPPER LEFT TO LOWER RIGHT
▀	UPPER HALF BLOCK
▄	LOWER HALF BLOCK
█	FULL BLOCK
▌	LEFT HALF BLOCK
▐	RIGHT HALF BLOCK
░	LIGHT SHADE
▒	MEDIUM SHADE
▓	DARK SHADE
■	BLACK SQUARE
□	WHITE SQUARE
▢	WHITE SQUARE WITH ROUNDED CORNERS
▣	WHITE SQUARE CONTAINING BLACK SMALL SQUARE
▤	SQUARE WITH HORIZONTAL FILL
▥	SQUARE WITH VERTICAL FILL
▦	SQUARE WITH ORTHOGONAL CROSSHATCH FILL
▧	SQUARE WITH UPPER LEFT TO LOWER RIGHT FILL
▨	SQUARE WITH UPPER RIGHT TO LOWER LEFT FILL
▩	SQUARE WITH DIAGONAL CROSSHATCH FILL
▪	BLACK SMALL SQUARE
▬	BLACK RECTANGLE
▭	WHITE RECTANGLE
▲	BLACK UP-POINTING TRIANGLE
△	WHITE UP-POINTING TRIANGLE
▶	BLACK RIGHT-POINTING TRIANGLE
▷	WHITE RIGHT-POINTING TRIANGLE
▼	BLACK DOWN-POINTING TRIANGLE
▽	WHITE DOWN-POINTING TRIANGLE
◀	BLACK LEFT-POINTING TRIANGLE
◁	WHITE LEFT-POINTING TRIANGLE
◆	BLACK DIAMOND
◇	WHITE DIAMOND
◊	LOZENGE
○	WHITE CIRCLE
◎	BULLSEYE
●	BLACK CIRCLE
◐	CIRCLE WITH LEFT HALF BLACK
◑	CIRCLE WITH RIGHT HALF BLACK
◘	INVERSE BULLET
◙	INVERSE WHITE CIRCLE
◢	BLACK LOWER RIGHT TRIANGLE
◣	BLACK LOWER LEFT TRIANGLE
★	BLACK STAR
☆	WHITE STAR
☜	WHITE LEFT POINTING INDEX
☞	WHITE RIGHT POINTING INDEX
☺	WHITE SMILING FACE
☻	BLACK SMILING FACE
☼	WHITE SUN WITH RAYS
♀	FEMALE SIGN
♂	MALE SIGN
♠	BLACK SPADE SUIT
♡	WHITE HEART SUIT
♢	WHITE DIAMOND SUIT
♣	BLACK CLUB SUIT
♩	QUARTER NOTE `
♪	EIGHTH NOTE `
♫	BEAMED EIGHTH NOTES
♭	MUSIC FLAT SIGN
♮	MUSIC NATURAL SIGN
♯	MUSIC SHARP SIGN
✓	CHECK MARK
✗	BALLOT X
✠	MALTESE CROSS
　	IDEOGRAPHIC SPACE
、	IDEOGRAPHIC COMMA
。	IDEOGRAPHIC FULL STOP
〃	DITTO MARK
〄	JAPANESE INDUSTRIAL STANDARD SYMBOL
々	IDEOGRAPHIC ITERATION MARK
〆	IDEOGRAPHIC CLOSING MARK
〇	IDEOGRAPHIC NUMBER ZERO
《	LEFT DOUBLE ANGLE BRACKET
》	RIGHT DOUBLE ANGLE BRACKET
「	LEFT CORNER BRACKET
」	RIGHT CORNER BRACKET
『	LEFT WHITE CORNER BRACKET
』	RIGHT WHITE CORNER BRACKET
【	LEFT BLACK LENTICULAR BRACKET
】	RIGHT BLACK LENTICULAR BRACKET
〒	POSTAL MARK
〓	GETA MARK
〔	LEFT TORTOISE SHELL BRACKET
〕	RIGHT TORTOISE SHELL BRACKET
〖	LEFT WHITE LENTICULAR BRACKET
〗	RIGHT WHITE LENTICULAR BRACKET
〜	WAVE DASH
ぁ	HIRAGANA LETTER SMALL A
あ	HIRAGANA LETTER A
ぃ	HIRAGANA LETTER SMALL I
い	HIRAGANA LETTER I
ぅ	HIRAGANA LETTER SMALL U
う	HIRAGANA LETTER U
ぇ	HIRAGANA LETTER SMALL E
え	HIRAGANA LETTER E
ぉ	HIRAGANA LETTER SMALL O
お	HIRAGANA LETTER O
か	HIRAGANA LETTER KA
が	HIRAGANA LETTER GA
き	HIRAGANA LETTER KI
ぎ	HIRAGANA LETTER GI
く	HIRAGANA LETTER KU
ぐ	HIRAGANA LETTER GU
け	HIRAGANA LETTER KE
げ	HIRAGANA LETTER GE
こ	HIRAGANA LETTER KO
ご	HIRAGANA LETTER GO
さ	HIRAGANA LETTER SA
ざ	HIRAGANA LETTER ZA
し	HIRAGANA LETTER SI
じ	HIRAGANA LETTER ZI
す	HIRAGANA LETTER SU
ず	HIRAGANA LETTER ZU
せ	HIRAGANA LETTER SE
ぜ	HIRAGANA LETTER ZE
そ	HIRAGANA LETTER SO
ぞ	HIRAGANA LETTER ZO
た	HIRAGANA LETTER TA
だ	HIRAGANA LETTER DA
ち	HIRAGANA LETTER TI
ぢ	HIRAGANA LETTER DI
っ	HIRAGANA LETTER SMALL TU
つ	HIRAGANA LETTER TU
づ	HIRAGANA LETTER DU
て	HIRAGANA LETTER TE
で	HIRAGANA LETTER DE
と	HIRAGANA LETTER TO
ど	HIRAGANA LETTER DO
な	HIRAGANA LETTER NA
に	HIRAGANA LETTER NI
ぬ	HIRAGANA LETTER NU
ね	HIRAGANA LETTER NE
の	HIRAGANA LETTER NO
は	HIRAGANA LETTER HA
ば	HIRAGANA LETTER BA
ぱ	HIRAGANA LETTER PA
ひ	HIRAGANA LETTER HI
び	HIRAGANA LETTER BI
ぴ	HIRAGANA LETTER PI
ふ	HIRAGANA LETTER HU
ぶ	HIRAGANA LETTER BU
ぷ	HIRAGANA LETTER PU
へ	HIRAGANA LETTER HE
べ	HIRAGANA LETTER BE
ぺ	HIRAGANA LETTER PE
ほ	HIRAGANA LETTER HO
ぼ	HIRAGANA LETTER BO
ぽ	HIRAGANA LETTER PO
ま	HIRAGANA LETTER MA
み	HIRAGANA LETTER MI
む	HIRAGANA LETTER MU
め	HIRAGANA LETTER ME
も	HIRAGANA LETTER MO
ゃ	HIRAGANA LETTER SMALL YA
や	HIRAGANA LETTER YA
ゅ	HIRAGANA LETTER SMALL YU
ゆ	HIRAGANA LETTER YU
ょ	HIRAGANA LETTER SMALL YO
よ	HIRAGANA LETTER YO
ら	HIRAGANA LETTER RA
り	HIRAGANA LETTER RI
る	HIRAGANA LETTER RU
れ	HIRAGANA LETTER RE
ろ	HIRAGANA LETTER RO
ゎ	HIRAGANA LETTER SMALL WA
わ	HIRAGANA LETTER WA
ゐ	HIRAGANA LETTER WI
ゑ	HIRAGANA LETTER WE
を	HIRAGANA LETTER WO
ん	HIRAGANA LETTER N `
ゔ	HIRAGANA LETTER VU
゛	KATAKANA-HIRAGANA VOICED SOUND MARK
゜	KATAKANA-HIRAGANA SEMI-VOICED SOUND MARK
ゝ	HIRAGANA ITERATION MARK
ゞ	HIRAGANA VOICED ITERATION MARK
ァ	KATAKANA LETTER SMALL A
ア	KATAKANA LETTER A
ィ	KATAKANA LETTER SMALL I
イ	KATAKANA LETTER I
ゥ	KATAKANA LETTER SMALL U
ウ	KATAKANA LETTER U
ェ	KATAKANA LETTER SMALL E
エ	KATAKANA LETTER E
ォ	KATAKANA LETTER SMALL O
オ	KATAKANA LETTER O
カ	KATAKANA LETTER KA
ガ	KATAKANA LETTER GA
キ	KATAKANA LETTER KI
ギ	KATAKANA LETTER GI
ク	KATAKANA LETTER KU
グ	KATAKANA LETTER GU
ケ	KATAKANA LETTER KE
ゲ	KATAKANA LETTER GE
コ	KATAKANA LETTER KO
ゴ	KATAKANA LETTER GO
サ	KATAKANA LETTER SA
ザ	KATAKANA LETTER ZA
シ	KATAKANA LETTER SI
ジ	KATAKANA LETTER ZI
ス	KATAKANA LETTER SU
ズ	KATAKANA LETTER ZU
セ	KATAKANA LETTER SE
ゼ	KATAKANA LETTER ZE
ソ	KATAKANA LETTER SO
ゾ	KATAKANA LETTER ZO
タ	KATAKANA LETTER TA
ダ	KATAKANA LETTER DA
チ	KATAKANA LETTER TI
ヂ	KATAKANA LETTER DI
ッ	KATAKANA LETTER SMALL TU
ツ	KATAKANA LETTER TU
ヅ	KATAKANA LETTER DU
テ	KATAKANA LETTER TE
デ	KATAKANA LETTER DE
ト	KATAKANA LETTER TO
ド	KATAKANA LETTER DO
ナ	KATAKANA LETTER NA
ニ	KATAKANA LETTER NI
ヌ	KATAKANA LETTER NU
ネ	KATAKANA LETTER NE
ノ	KATAKANA LETTER NO
ハ	KATAKANA LETTER HA
バ	KATAKANA LETTER BA
パ	KATAKANA LETTER PA
ヒ	KATAKANA LETTER HI
ビ	KATAKANA LETTER BI
ピ	KATAKANA LETTER PI
フ	KATAKANA LETTER HU
ブ	KATAKANA LETTER BU
プ	KATAKANA LETTER PU
ヘ	KATAKANA LETTER HE
ベ	KATAKANA LETTER BE
ペ	KATAKANA LETTER PE
ホ	KATAKANA LETTER HO
ボ	KATAKANA LETTER BO
ポ	KATAKANA LETTER PO
マ	KATAKANA LETTER MA
ミ	KATAKANA LETTER MI
ム	KATAKANA LETTER MU
メ	KATAKANA LETTER ME
モ	KATAKANA LETTER MO
ャ	KATAKANA LETTER SMALL YA
ヤ	KATAKANA LETTER YA
ュ	KATAKANA LETTER SMALL YU
ユ	KATAKANA LETTER YU
ョ	KATAKANA LETTER SMALL YO
ヨ	KATAKANA LETTER YO
ラ	KATAKANA LETTER RA
リ	KATAKANA LETTER RI
ル	KATAKANA LETTER RU
レ	KATAKANA LETTER RE
ロ	KATAKANA LETTER RO
ヮ	KATAKANA LETTER SMALL WA
ワ	KATAKANA LETTER WA
ヰ	KATAKANA LETTER WI
ヱ	KATAKANA LETTER WE
ヲ	KATAKANA LETTER WO
ン	KATAKANA LETTER N `
ヴ	KATAKANA LETTER VU
ヵ	KATAKANA LETTER SMALL KA
ヶ	KATAKANA LETTER SMALL KE
ヷ	KATAKANA LETTER VA
ヸ	KATAKANA LETTER VI
ヹ	KATAKANA LETTER VE
ヺ	KATAKANA LETTER VO
・	KATAKANA MIDDLE DOT
ー	KATAKANA-HIRAGANA PROLONGED SOUND MARK
ヽ	KATAKANA ITERATION MARK
ヾ	KATAKANA VOICED ITERATION MARK
ㄅ	BOPOMOFO LETTER B
ㄆ	BOPOMOFO LETTER P
ㄇ	BOPOMOFO LETTER M
ㄈ	BOPOMOFO LETTER F
ㄉ	BOPOMOFO LETTER D
ㄊ	BOPOMOFO LETTER T
ㄋ	BOPOMOFO LETTER N `
ㄌ	BOPOMOFO LETTER L
ㄍ	BOPOMOFO LETTER G
ㄎ	BOPOMOFO LETTER K
ㄏ	BOPOMOFO LETTER H
ㄐ	BOPOMOFO LETTER J
ㄑ	BOPOMOFO LETTER Q
ㄒ	BOPOMOFO LETTER X
ㄓ	BOPOMOFO LETTER ZH
ㄔ	BOPOMOFO LETTER CH
ㄕ	BOPOMOFO LETTER SH
ㄖ	BOPOMOFO LETTER R
ㄗ	BOPOMOFO LETTER Z
ㄘ	BOPOMOFO LETTER C
ㄙ	BOPOMOFO LETTER S
ㄚ	BOPOMOFO LETTER A
ㄛ	BOPOMOFO LETTER O
ㄜ	BOPOMOFO LETTER E
ㄞ	BOPOMOFO LETTER AI
ㄟ	BOPOMOFO LETTER EI
ㄠ	BOPOMOFO LETTER AU
ㄡ	BOPOMOFO LETTER OU
ㄢ	BOPOMOFO LETTER AN
ㄣ	BOPOMOFO LETTER EN
ㄤ	BOPOMOFO LETTER ANG
ㄥ	BOPOMOFO LETTER ENG
ㄦ	BOPOMOFO LETTER ER
ㄧ	BOPOMOFO LETTER I
ㄨ	BOPOMOFO LETTER U
ㄩ	BOPOMOFO LETTER IU
ㄪ	BOPOMOFO LETTER V
ㄫ	BOPOMOFO LETTER NG
ㄬ	BOPOMOFO LETTER GN
㈠	PARENTHESIZED IDEOGRAPH ONE
㈡	PARENTHESIZED IDEOGRAPH TWO
㈢	PARENTHESIZED IDEOGRAPH THREE
㈣	PARENTHESIZED IDEOGRAPH FOUR
㈤	PARENTHESIZED IDEOGRAPH FIVE
㈥	PARENTHESIZED IDEOGRAPH SIX
㈦	PARENTHESIZED IDEOGRAPH SEVEN
㈧	PARENTHESIZED IDEOGRAPH EIGHT
㈨	PARENTHESIZED IDEOGRAPH NINE
ﬀ	LATIN SMALL LIGATURE FF
ﬁ	LATIN SMALL LIGATURE FI
ﬂ	LATIN SMALL LIGATURE FL
ﬅ	LATIN SMALL LIGATURE LONG S T
ﬆ	LATIN SMALL LIGATURE ST
